110
8
0 0 0 0 0 0 0 0 0 0 0 0 0 0 0 0 0 0 0 0 0 0 0 0 0 0 0 0 0 0 0 0 0 0 0 0 0 0 0 0 0 0 0 0 0 0 0 0 0 0 0 0 0 0 0 0 0 0 0 0 0 0 0 0 0 0 0 0 0 0 0 0 0 0 0 0 0 0 0 0 0 0 0 0 0 0 0 0 0 0 27 1 1 1 1 1 1 1 1 28 0 0 0 0 0 0 0 0 0 0 
0 0 0 0 0 0 0 0 0 0 0 0 0 0 0 0 0 0 0 0 0 0 0 0 0 0 0 0 0 0 0 0 0 0 0 0 0 0 0 0 0 0 0 0 0 0 0 0 0 0 0 0 0 0 0 0 0 0 0 0 0 0 0 0 0 0 0 0 0 0 0 0 0 0 0 0 0 0 0 0 0 0 0 0 0 0 0 0 0 0 24 7 1 1 1 1 1 1 1 28 0 0 0 0 0 0 0 0 0 0 
0 0 0 0 0 0 0 0 0 0 0 0 0 0 0 0 0 0 0 0 0 0 0 0 11 12 13 0 0 0 0 0 0 0 0 0 0 0 0 0 0 0 0 0 0 0 0 0 0 0 0 0 0 0 0 0 0 0 0 0 0 0 0 0 0 0 0 0 0 0 0 0 0 0 0 0 0 0 0 0 0 0 0 0 0 0 0 0 0 0 0 24 7 1 1 1 1 1 1 28 0 0 0 0 0 0 0 0 0 0 
22 22 22 22 22 23 0 0 0 0 0 0 0 0 0 0 0 0 0 0 0 21 22 22 22 22 22 23 0 0 0 0 29 0 0 0 0 0 0 29 0 0 0 0 0 0 0 0 0 0 0 0 0 0 0 0 0 0 0 0 0 0 0 0 0 0 0 0 0 0 21 22 22 22 22 23 0 0 0 0 0 0 0 0 0 0 0 0 0 0 0 0 24 25 25 25 25 25 25 26 0 0 0 0 0 0 0 11 12 13 
1 1 1 1 8 26 0 16 17 0 0 0 0 0 0 0 0 0 0 0 0 27 1 1 1 1 1 28 0 0 0 0 0 0 0 0 0 0 0 0 0 0 0 0 29 0 0 0 0 0 0 0 0 0 0 0 0 0 0 0 0 0 0 0 0 0 0 0 0 0 24 7 1 1 8 26 0 0 0 0 0 0 16 17 0 0 0 0 0 0 0 0 0 0 0 0 0 0 0 0 0 0 0 0 0 0 21 22 22 22 
1 1 1 1 28 0 0 14 15 0 0 0 0 21 22 22 22 23 0 0 21 22 2 1 1 1 3 22 22 23 0 0 0 0 0 29 0 0 0 0 0 0 0 0 0 0 0 0 0 0 0 0 0 0 0 0 0 0 0 0 0 0 0 0 0 0 0 29 16 17 0 27 1 1 28 0 0 0 0 0 21 22 22 23 0 0 0 0 0 0 0 0 0 0 0 0 16 17 0 0 0 0 0 0 29 0 24 7 1 1 
1 1 1 1 3 22 22 22 22 22 22 22 22 2 1 1 1 28 0 0 27 1 1 1 1 1 1 1 1 28 0 0 0 0 0 0 0 0 0 0 0 0 29 0 0 0 0 0 0 0 21 22 23 0 0 0 11 12 13 0 0 0 0 0 0 0 0 0 14 15 0 27 1 1 28 0 0 0 0 0 24 7 8 26 0 0 0 0 21 22 22 22 23 0 0 0 14 15 0 21 23 0 29 0 0 0 0 27 1 1 
1 1 1 1 1 1 1 1 1 1 1 1 1 1 1 1 1 28 0 0 27 1 1 1 1 1 1 1 1 28 0 0 0 0 0 0 0 0 0 0 0 0 0 0 0 0 0 0 0 0 24 3 22 22 22 22 22 22 22 22 22 22 22 22 22 22 22 22 22 22 22 22 2 1 28 0 0 0 0 0 0 27 28 0 0 0 0 0 24 1 1 1 3 22 22 22 22 22 22 2 28 0 0 0 0 0 0 27 1 1 
