110
8
0 0 0 0 0 0 0 0 0 0 0 0 0 0 0 0 0 0 0 0 0 0 0 0 0 0 0 0 0 0 0 0 0 0 0 0 0 0 0 0 0 0 0 0 0 0 0 0 0 0 0 0 0 0 0 0 0 0 0 0 0 0 0 0 0 0 0 0 0 0 0 0 0 0 0 0 0 0 0 0 0 0 0 0 0 21 1 1 1 1 1 1 1 1 1 1 1 3 1 1 1 1 1 1 1 31 0 0 0 0 
0 0 0 0 0 0 0 0 0 0 0 0 0 0 0 0 0 0 0 0 0 0 0 0 0 0 0 0 0 0 0 0 0 0 0 0 0 0 0 0 0 0 0 23 24 24 24 25 0 0 0 0 0 0 0 0 0 0 0 0 0 0 0 0 0 0 0 0 0 0 0 0 0 0 0 0 0 0 0 0 0 0 0 0 0 29 30 30 30 30 1 1 1 3 1 1 1 1 1 1 1 1 1 3 31 0 0 0 0 0 
0 0 0 0 0 0 0 0 0 0 0 0 0 0 0 0 0 0 0 0 0 0 0 0 0 0 0 0 0 0 0 0 0 0 0 0 0 0 23 25 0 0 0 0 0 0 0 0 0 0 0 0 0 0 0 0 0 0 0 0 0 0 0 0 0 0 0 0 0 0 0 0 0 0 0 0 0 0 0 0 0 0 0 0 0 0 0 0 0 0 29 30 30 30 1 1 1 1 1 1 1 1 1 31 0 0 0 0 0 0 
0 0 0 0 0 0 0 0 0 0 0 0 0 0 0 0 0 0 0 0 0 0 0 0 0 0 0 0 0 0 0 0 0 0 0 0 0 0 0 0 0 0 0 0 0 0 0 0 0 0 0 0 0 0 0 0 0 0 0 0 0 0 0 0 0 0 12 13 14 0 0 0 0 0 0 0 0 0 0 0 0 0 0 0 0 0 0 0 0 0 0 0 0 0 29 30 1 1 1 1 3 1 31 0 0 0 0 0 0 0 
0 0 0 0 0 0 0 0 0 5 0 0 0 0 0 0 0 0 0 0 0 0 0 0 0 0 0 0 0 0 0 0 0 6 7 0 0 0 0 5 0 0 23 25 0 0 0 0 0 0 0 0 0 0 0 0 0 0 0 0 0 0 0 0 0 0 9 10 11 0 0 0 0 0 0 0 0 0 0 0 0 5 0 0 0 0 26 27 28 0 0 8 0 0 0 0 29 1 1 1 1 31 0 0 0 0 4 5 4 4 
0 0 0 0 0 0 0 0 23 24 25 0 0 0 0 0 0 4 0 0 0 0 0 0 0 0 0 0 0 0 0 0 26 27 27 27 27 27 27 27 28 0 0 0 0 0 0 0 0 0 0 0 0 0 0 0 0 0 0 0 0 0 0 0 23 27 27 27 27 27 27 24 24 25 0 0 0 0 0 0 23 24 25 0 0 0 21 1 31 27 27 28 0 0 0 0 0 29 30 30 31 0 0 0 0 26 27 27 27 27 
0 0 4 0 0 0 0 0 0 0 0 0 0 0 0 0 23 24 25 0 0 26 28 0 0 5 4 0 0 26 28 0 21 1 3 1 1 1 1 1 22 0 0 0 0 0 0 0 0 0 0 0 0 0 0 0 0 0 5 0 0 0 0 0 0 29 1 1 3 1 22 0 0 0 0 0 4 0 0 0 0 0 0 0 0 0 21 1 1 1 3 22 27 27 27 28 0 0 0 0 0 0 8 0 26 21 1 3 1 22 
0 26 27 27 28 0 0 0 0 0 0 0 0 0 0 0 0 0 0 0 0 21 22 27 27 27 27 27 27 21 22 0 21 1 1 1 1 2 1 1 22 0 0 0 0 0 0 0 0 0 0 0 0 0 0 26 27 27 27 27 28 0 0 0 0 29 1 1 1 1 22 0 0 0 0 26 28 0 0 0 0 0 0 0 0 0 21 1 2 1 1 1 1 1 1 22 27 27 27 27 27 27 27 27 21 1 1 1 1 22 
